1111111111111
1001000001111
1000010101001
1P0011E000C01
1111111111111
1111111111111