1111111111111
10010000000C1
1100000000111
1P00000000CE1
1111111111111
