11111
1P0C1
11E01
11111
10111
11111
